A1,A1,A1,A1,A1,A1,D7,A7,D4,A2,A1,D7,A7,A7,A7,A7,A7,A7,A7,A7,A7,A7,D4,A1,A1,A1,A1,A1,A1,D7,A7,A7
A1,A1,C7,C7,C7,A1,A1,D9,C5,C5,C5,A1,D2,A7,A7,A7,A7,A7,A7,A7,A7,D4,A1,A1,A1,A1,A1,A1,A1,A2,D2,A7
A1,A1,C7,C7,C7,A1,A1,A6,C5,C5,C5,A1,D2,A7,A7,A7,A7,A7,D3,A7,D5,A1,A1,A1,A1,B7,A2,A1,A2,A1,D2,A7
A1,A1,A1,A1,A2,A1,A1,D9,A1,A1,A1,A2,D2,A7,A7,D3,D3,D4,A1,D2,D5,A1,A2,A1,A1,A1,C9,D1,D1,D1,A7,A7
A1,A1,A1,A1,A1,A2,A1,D9,A2,A1,A1,C9,A7,A7,D4,A1,A1,A1,A1,D2,A7,D6,A2,A1,C9,D1,A7,A7,A7,A7,A7,A7
A1,A1,A1,B7,A1,A1,A1,D9,A1,A1,A1,D7,A7,D5,A1,A1,B9,A1,A1,D7,A7,D3,D8,A5,A7,D3,D3,A7,A7,A7,A7,A7
A3,A1,A1,A1,A1,A1,A1,A6,A1,A1,A1,A1,D7,D5,A1,A1,A1,A1,A1,A1,D9,A1,A1,A1,D2,D6,A1,D2,A7,A7,A7,A7
A3,A1,A1,A1,A1,A1,A1,D9,A1,A1,A1,A1,A1,A6,A1,A1,A1,A1,A1,A1,A6,A1,B7,A1,D7,A7,D1,A7,A7,A7,A7,A7
A3,A3,E3,D8,D8,A5,D8,E5,A5,D8,E1,A1,A1,D9,A1,A1,A1,E3,D8,D8,E4,A1,A1,A1,A1,D2,A7,A7,A7,A7,A7,A7
A3,A3,D9,B1,B1,A1,B1,B1,A1,B1,D9,A1,A1,D9,A1,A2,A1,D9,A1,A1,A1,A1,A1,A1,A1,D2,A7,A7,A7,A7,A7,A7
A3,A3,D9,A3,A1,A1,A1,C1,B8,A1,A6,A1,A1,A6,A1,A1,A1,A6,A1,A1,A1,A2,A2,A1,A1,D2,A7,A7,A7,A7,A7,A7
D8,D8,E4,A3,A3,A1,A1,A1,A1,A9,D9,A1,A2,D9,A1,A1,A1,D9,A1,B9,A1,A1,A1,A1,C9,A7,A7,A7,A7,A7,A7,A7
A3,A3,A3,A3,A3,A3,A2,B9,A1,A9,E2,D8,D8,E5,D8,D8,A5,E5,E1,A1,A1,A1,A1,A1,D2,A7,A7,A7,A7,A7,A7,A7
A3,A3,A3,A3,A3,A3,A3,A3,A3,A1,B1,B1,B1,B1,B1,B1,A1,B1,D9,A1,A1,A1,A1,A1,D2,A7,D3,D3,D3,A7,A7,A7
A3,A3,A3,A3,A3,A3,A3,A3,A3,A3,A3,A3,A3,A3,A3,A3,A3,A3,D9,A1,A1,A1,A1,A1,D7,D4,A1,A1,A1,D7,A7,A7