A7,A7,A7,A7,A7,A7,A7,A7,A7,A7,A7,A7,A7,A7,A7,A7,A7,A7,A7,A7,A7,A7,A7,A7,A7,A7,A7,A7,A7,A7,A7,A7
A7,A7,A7,A7,A7,D3,D3,D3,A7,A7,A7,A7,A7,A7,A7,A7,A7,A7,A7,A7,A7,A7,A7,A7,A7,A7,D3,A7,A7,A7,A7,A7
A7,A7,A7,A7,D4,A1,A1,A1,D7,A7,A7,A7,A7,A7,A7,A7,A7,A7,A7,A7,D3,D3,D3,D3,D3,D4,A2,D7,D3,A7,A7,A7
A7,A7,A7,D4,A1,A1,A1,A2,A3,D7,A7,A7,A7,A7,A7,A7,D3,D3,D3,D4,B9,B9,B9,A1,A1,A2,B8,A2,A1,D7,A7,A7
A7,A7,D4,A1,C7,A1,A1,A1,A3,A3,D7,A7,A7,A7,A7,D4,B7,A1,A1,A1,A1,A1,A1,A1,A1,A1,C5,A1,A1,A1,D2,A7
A7,D5,A1,A1,A1,A1,A1,A1,A3,A3,A3,D7,D3,D3,D4,A1,A1,A1,A1,A1,A2,A1,A1,A1,A1,A1,A1,A1,A1,A1,D2,A7
A7,D5,A1,A1,A1,A1,A1,A2,A3,A3,A3,A3,A3,A3,A1,A1,A1,A1,A1,A1,A1,C9,D1,D6,A1,A1,A1,A1,A1,A1,D2,A7
A7,D5,A1,A1,A1,A1,A1,A1,A2,A3,A3,A3,A2,A1,A1,A1,A2,A1,A1,A1,C9,A7,D3,D4,A1,B7,A1,A1,A1,A1,D2,A7
A7,D5,A1,C5,A1,A1,A1,A1,A1,A4,A4,A2,A1,A1,A1,A1,A1,A1,C9,D1,A7,D4,A1,A1,A1,A1,A1,A1,A1,C9,A7,A7
A7,D5,A1,A1,A1,A1,A1,A1,A4,A1,A1,A1,A1,A1,A1,A1,A2,A2,D2,A7,D4,C6,A1,A1,A1,A1,A1,A1,C9,A7,A7,A7
A7,A7,D6,A1,A1,A1,A1,A1,A1,B7,A1,A1,A1,A1,A1,A2,A2,C9,A7,D5,A2,A1,A1,A1,A1,A2,A1,C9,A7,A7,A7,A7
A7,A7,A7,D6,A1,A1,A1,A1,A1,A1,A1,A1,A2,A1,A1,C9,D1,A7,A7,A7,D6,A1,A1,A2,A1,A1,A1,D2,A7,A7,A7,A7
A7,A7,A7,A7,D6,A1,B9,B9,C9,D1,D1,D6,A1,A1,C9,A7,A7,A7,A7,A7,A7,D1,D1,D1,D6,A2,A2,D2,A7,A7,A7,A7
A7,A7,A7,A7,A7,D1,D1,D1,A7,A7,A7,A7,D1,D1,A7,A7,A7,A7,A7,A7,A7,A7,A7,A7,A7,D1,D1,A7,A7,A7,A7,A7
A7,A7,A7,A7,A7,A7,A7,A7,A7,A7,A7,A7,A7,A7,A7,A7,A7,A7,A7,A7,A7,A7,A7,A7,A7,A7,A7,A7,A7,A7,A7,A7